0 0 0 0 0 0 0 0 0 0 0 0 0 0 0 0 0 0 0 0 0 0 0 0 0 0 0 0 0 0 0 0 0 0 0 0 0 0 0 0 0 0 0 0 0 0 0 0 0 0 
0 0 0 0 32 18 15 18 15 18 15 18 15 18 33 0 0 0 0 0 0 0 0 0 0 0 0 0 0 0 0 0 0 0 0 0 0 0 0 0 0 0 0 0 0 0 0 0 0 0 
0 0 0 0 30 8 57 64 57 8 23 55 57 8 31 0 0 0 0 0 0 0 0 0 0 0 0 0 0 0 0 0 0 0 0 0 0 0 0 0 0 0 0 0 0 0 0 0 0 0 
0 0 0 0 30 38 58 67 58 67 58 56 58 67 31 0 0 0 0 0 0 0 0 0 0 0 0 0 0 0 0 0 0 0 0 0 0 0 0 0 0 0 0 0 0 0 0 0 0 0 
0 0 0 0 30 67 65 2 67 67 67 1 65 67 31 0 0 0 0 0 0 0 0 0 0 0 0 0 0 0 0 0 0 0 0 0 0 0 0 0 0 0 0 0 0 0 0 0 0 0 
0 0 0 0 30 67 0 3 67 67 67 38 0 2 31 0 0 0 0 0 0 0 0 0 0 0 0 0 0 0 0 0 0 0 0 0 0 0 0 0 0 0 0 0 0 0 0 0 0 0 
0 0 0 0 30 5 60 67 67 67 67 67 60 38 31 0 0 0 0 0 0 0 0 0 0 0 0 0 0 0 0 0 0 0 0 0 0 0 0 0 0 0 0 0 0 0 0 0 0 0 
0 0 0 0 30 2 57 67 67 67 67 6 57 67 31 0 0 0 0 0 0 0 0 0 0 0 0 0 0 0 0 0 0 0 0 0 0 0 0 0 0 0 0 0 0 0 0 0 0 0 
0 0 0 0 30 38 58 67 67 67 67 67 58 39 31 0 0 0 0 0 0 0 0 0 0 0 0 0 0 0 0 0 0 0 0 0 0 0 0 0 0 0 0 0 0 0 0 0 0 0 
0 0 0 0 30 68 68 71 67 67 67 68 68 68 31 0 0 0 0 0 32 18 18 15 18 15 18 18 33 0 0 0 0 0 0 0 0 0 0 0 0 0 0 0 0 0 0 0 0 0 
0 0 0 0 28 8 8 14 67 67 5 13 9 8 29 0 0 0 0 0 30 8 8 57 64 57 8 55 31 0 0 0 0 0 0 0 0 0 0 0 0 0 0 0 0 0 0 0 0 0 
0 0 0 0 0 65 65 30 67 67 67 24 18 15 18 15 18 15 18 18 25 2 67 58 67 58 67 56 31 0 0 0 0 0 0 0 0 0 0 0 0 0 0 0 0 0 0 0 0 0 
0 0 0 0 0 0 0 30 3 67 67 8 22 57 64 57 8 57 55 12 22 2 67 65 65 65 2 67 31 0 0 0 0 0 0 0 0 0 0 0 0 0 0 0 0 0 0 0 0 0 
0 0 0 0 0 0 0 30 67 67 67 2 67 58 67 58 67 2 56 67 67 67 2 67 67 67 2 67 31 0 0 0 0 0 0 0 0 0 0 0 0 0 0 0 0 0 0 0 0 0 
0 0 0 0 0 0 0 30 67 2 67 2 67 67 2 2 67 67 67 2 67 67 5 65 67 65 3 67 31 0 0 0 0 0 0 0 0 0 0 0 0 0 0 0 0 0 0 0 0 0 
0 0 0 0 0 0 0 30 68 68 68 68 68 68 68 68 68 68 68 68 68 2 6 0 67 0 7 67 31 0 0 0 0 0 0 0 0 0 0 0 0 0 0 0 0 0 0 0 0 0 
0 0 0 0 0 0 0 28 8 8 8 8 8 8 8 8 8 8 8 8 21 67 67 67 1 67 1 67 31 0 0 0 0 0 0 0 0 0 0 0 0 0 0 0 0 0 0 0 0 0 
0 0 0 0 0 0 0 0 65 65 65 65 65 65 65 65 65 65 65 0 14 74 71 67 67 67 68 74 31 0 0 0 0 0 0 0 0 0 0 0 0 0 0 0 0 0 0 0 0 0 
0 0 0 0 0 0 0 0 0 0 0 0 0 0 0 0 0 0 0 0 8 8 14 67 67 67 13 10 29 0 0 0 0 0 0 0 0 0 0 0 0 0 0 0 0 0 0 0 0 0 
0 0 0 0 0 0 0 0 0 0 0 0 0 0 0 0 0 0 0 0 32 18 25 64 4 64 24 18 33 0 32 18 15 18 15 18 15 18 33 0 0 0 0 0 0 0 0 0 0 0 
0 0 0 0 0 0 0 0 0 0 0 0 0 0 0 0 0 0 0 0 30 8 8 67 67 67 8 8 31 0 30 8 57 8 57 8 57 8 31 0 0 0 0 0 0 0 0 0 0 0 
0 0 0 0 0 0 0 0 0 0 0 0 0 0 0 0 0 0 0 0 30 7 67 67 67 67 67 6 24 15 25 67 58 38 58 38 58 1 24 15 18 18 15 18 18 15 18 18 33 0 
0 0 0 0 0 0 0 0 0 0 0 0 0 0 0 0 0 0 0 0 30 67 65 67 67 67 65 67 8 57 8 67 65 65 65 65 65 67 8 57 8 8 57 8 12 22 55 8 31 0 
0 0 0 0 0 0 0 0 0 0 0 0 0 0 0 0 0 0 0 0 30 4 67 67 4 4 67 67 67 58 67 67 67 6 7 4 67 67 67 58 67 67 58 67 4 58 56 1 31 0 
0 0 0 0 0 0 0 0 0 0 0 0 0 0 0 0 0 0 0 0 30 67 67 67 4 67 67 67 4 67 67 67 4 67 67 67 67 67 4 67 4 67 67 67 67 67 67 67 31 0 
0 0 0 0 0 0 0 0 0 0 0 0 0 0 0 0 0 0 0 0 30 67 65 4 67 67 65 67 68 68 68 67 67 67 4 67 67 67 68 68 68 68 68 68 68 67 67 67 31 0 
0 0 0 0 0 0 0 0 0 0 0 0 0 0 0 0 0 0 0 0 30 67 68 67 4 67 68 67 13 8 14 1 68 67 68 67 68 67 13 8 8 8 8 8 14 67 67 67 31 0 
0 0 0 0 0 0 0 0 0 0 0 0 0 0 0 0 0 0 0 0 30 71 64 71 68 68 64 68 31 65 30 68 64 68 64 68 64 68 31 65 65 65 65 65 30 67 65 67 31 0 
0 0 0 0 0 0 0 0 0 0 0 0 0 0 0 0 0 0 0 0 28 8 8 8 8 8 8 8 29 0 28 8 8 8 8 8 8 8 29 0 0 0 0 0 30 67 7 67 31 0 
0 0 0 0 0 0 0 0 0 0 0 0 0 0 0 0 0 0 0 0 0 65 65 65 65 65 65 65 0 0 0 65 65 65 65 65 65 65 0 0 0 0 0 0 30 67 65 67 31 0 
0 0 0 0 0 0 0 0 0 0 0 0 0 0 0 0 0 0 0 0 0 0 0 0 0 0 0 0 0 0 0 0 0 0 0 0 0 0 0 0 0 0 0 0 30 67 6 67 31 0 
0 0 0 0 0 0 0 0 0 0 0 0 32 0 0 0 0 32 18 15 18 18 15 18 33 0 0 0 0 0 0 32 15 15 18 15 15 18 15 15 33 0 0 0 30 67 65 67 31 0 
0 0 0 0 0 0 0 0 0 0 0 0 30 58 33 0 0 30 8 22 22 8 57 8 31 0 0 0 0 0 0 30 57 57 12 57 23 55 22 57 31 0 0 0 30 2 38 2 31 0 
0 0 0 0 0 0 0 0 0 0 0 0 30 67 31 0 0 30 38 58 18 59 58 5 24 15 18 18 18 18 15 25 58 58 38 58 58 56 58 58 24 18 15 15 25 67 65 67 31 0 
0 0 0 0 0 0 0 0 0 16 18 18 25 67 24 19 18 25 2 67 40 51 67 6 8 57 64 11 9 8 57 8 6 65 65 7 67 65 65 3 8 8 57 23 64 67 67 2 31 0 
0 0 0 0 0 0 0 0 0 22 8 8 8 67 9 8 8 8 67 67 1 43 67 67 67 58 67 67 4 67 58 67 67 67 67 2 67 67 67 67 4 67 58 58 67 67 2 2 31 0 
0 0 0 0 0 0 0 0 0 1 68 68 68 37 68 68 68 68 67 5 3 67 2 4 67 68 67 4 67 67 68 67 67 4 67 67 2 67 4 2 67 68 67 68 67 2 2 67 31 0 
0 0 0 0 0 0 0 0 0 65 8 8 14 67 13 8 8 14 67 6 7 67 67 1 68 9 68 68 68 68 9 68 67 67 4 4 67 67 2 67 68 9 68 9 68 68 68 74 31 0 
0 0 0 0 0 0 0 0 0 0 65 65 30 67 31 65 65 30 67 68 67 67 68 38 13 8 8 8 8 8 8 14 67 68 2 68 68 67 68 67 13 8 8 8 8 8 8 8 29 0 
0 0 0 0 0 0 0 0 0 0 0 0 30 67 31 0 0 30 68 23 68 68 22 68 31 65 65 65 65 65 65 30 68 64 68 8 8 68 64 68 31 65 65 65 65 65 65 65 0 0 
0 0 0 0 0 0 0 0 0 0 0 0 30 68 31 0 0 28 8 8 8 8 8 8 29 0 0 0 0 0 0 28 8 8 8 8 8 8 8 8 29 0 0 0 0 0 0 0 0 0 
0 0 0 0 0 0 0 0 0 0 0 0 28 10 29 0 0 0 65 65 65 65 65 65 0 0 0 0 0 0 0 0 65 65 65 65 65 65 65 65 0 0 0 0 0 0 0 0 0 0 
0 0 0 0 0 0 0 0 0 0 0 0 0 65 0 0 0 0 0 0 0 0 0 0 0 0 0 0 0 0 0 0 0 0 0 0 0 0 0 0 0 0 0 0 0 0 0 0 0 0 
0 0 0 0 0 0 0 0 0 0 0 0 0 0 0 0 0 0 0 0 0 0 0 0 0 0 0 0 0 0 0 0 0 0 0 0 0 0 0 0 0 0 0 0 0 0 0 0 0 0 
0 0 0 0 0 0 0 0 0 0 0 0 0 0 0 0 0 0 0 0 0 0 0 0 0 0 0 0 0 0 0 0 0 0 0 0 0 0 0 0 0 0 0 0 0 0 0 0 0 0 
0 0 0 0 0 0 0 0 0 0 0 0 0 0 0 0 0 0 0 0 0 0 0 0 0 0 0 0 0 0 0 0 0 0 0 0 0 0 0 0 0 0 0 0 0 0 0 0 0 0 
0 0 0 0 0 0 0 0 0 0 0 0 0 0 0 0 0 0 0 0 0 0 0 0 0 0 0 0 0 0 0 0 0 0 0 0 0 0 0 0 0 0 0 0 0 0 0 0 0 0 
0 0 0 0 0 0 0 0 0 0 0 0 0 0 0 0 0 0 0 0 0 0 0 0 0 0 0 0 0 0 0 0 0 0 0 0 0 0 0 0 0 0 0 0 0 0 0 0 0 0 
0 0 0 0 0 0 0 0 0 0 0 0 0 0 0 0 0 0 0 0 0 0 0 0 0 0 0 0 0 0 0 0 0 0 0 0 0 0 0 0 0 0 0 0 0 0 0 0 0 0 
0 0 0 0 0 0 0 0 0 0 0 0 0 0 0 0 0 0 0 0 0 0 0 0 0 0 0 0 0 0 0 0 0 0 0 0 0 0 0 0 0 0 0 0 0 0 0 0 0 0 
