0 0 0 32 59 33 0 0 32 15 33 0 0 32 59 33 0 0 0 0 0 0 0 0 32 18 18 18 33 0 0 0 0 0 0 0 0 0 0 0 0 32 18 18 18 33 0 0 0 0 
0 0 0 30 42 31 0 32 25 57 24 33 0 30 42 31 0 0 0 0 0 0 0 0 30 8 42 8 31 0 0 0 0 0 0 0 0 0 0 0 0 30 8 42 8 31 0 0 0 0 
0 0 0 30 37 24 18 25 55 58 10 24 18 25 37 31 0 0 0 0 0 0 0 0 30 67 37 67 31 0 0 0 0 0 0 0 0 0 0 0 0 30 67 37 67 31 0 0 0 0 
0 0 0 30 3 8 8 8 56 67 6 8 40 8 2 31 0 0 0 0 0 0 0 0 30 67 67 67 31 0 0 0 0 0 0 0 0 0 0 0 0 30 67 67 67 31 0 0 0 0 
0 0 0 30 68 68 68 68 2 68 67 68 68 68 68 31 0 0 0 0 0 0 32 18 25 67 67 67 24 18 33 0 0 0 0 0 0 0 0 32 15 25 67 67 67 24 15 33 0 0 
0 0 0 28 23 9 8 21 67 40 2 20 22 8 23 29 0 0 0 0 0 0 30 8 42 67 67 67 42 8 31 0 0 0 0 0 0 0 0 30 57 42 67 67 67 42 57 31 0 0 
0 0 0 0 65 65 65 30 67 65 67 31 65 65 65 0 0 0 0 0 32 15 25 67 67 67 67 67 67 67 24 15 33 0 0 0 0 32 15 25 58 67 67 67 67 67 58 24 15 33 
0 0 0 0 0 0 0 30 67 59 2 31 0 0 0 0 0 0 0 0 30 57 42 67 38 67 67 67 38 67 42 57 31 0 0 0 0 30 57 42 67 67 67 67 67 67 67 42 57 31 
0 0 0 0 0 0 0 30 2 50 67 31 0 0 0 0 0 0 0 0 30 58 67 38 67 67 67 67 67 38 67 58 31 0 0 0 0 30 58 67 67 65 67 67 38 65 67 67 58 31 
0 0 0 0 0 0 0 30 67 43 2 31 0 0 0 0 0 0 0 0 28 8 21 67 67 67 15 67 67 67 20 8 29 0 0 0 0 30 67 67 67 15 67 67 67 15 67 67 67 31 
0 0 0 0 0 0 0 30 67 6 7 31 0 0 0 0 0 0 0 0 32 15 25 67 67 67 57 67 67 67 24 15 33 0 0 0 0 30 67 67 67 57 38 67 67 57 67 67 67 31 
0 0 0 0 0 0 0 30 68 68 68 31 0 0 0 0 0 0 0 0 30 57 42 67 67 67 58 67 67 67 42 57 31 0 0 0 0 30 67 67 67 58 67 67 67 58 67 67 67 31 
0 0 0 0 0 0 0 28 8 22 8 29 0 0 0 0 0 0 0 0 30 58 67 38 67 67 67 67 67 38 67 58 31 0 0 0 0 30 68 68 38 67 67 67 67 67 67 68 68 31 
0 0 0 0 0 0 0 0 0 0 0 0 0 0 0 0 0 0 0 0 28 8 14 67 38 67 67 67 38 67 20 8 29 0 0 0 0 28 8 21 67 67 67 67 67 67 38 20 8 29 
0 0 0 0 0 0 0 0 0 0 0 0 0 0 0 0 0 0 0 0 0 65 30 68 68 67 67 67 68 68 31 65 0 0 0 0 0 0 65 30 68 71 67 67 67 68 68 31 65 0 
0 0 0 0 0 0 0 0 0 0 0 0 0 0 0 0 0 0 0 0 0 0 28 8 14 67 67 67 13 8 29 0 0 0 0 0 0 0 0 28 8 14 67 67 67 13 8 29 0 0 
0 0 0 0 0 0 0 0 0 0 0 0 0 0 0 0 0 0 0 0 0 0 0 65 30 67 67 67 31 65 0 0 0 0 0 0 0 0 0 0 65 30 67 67 67 31 65 0 0 0 
0 0 0 0 0 0 0 0 0 0 0 0 0 0 0 0 0 0 0 0 0 0 0 0 30 67 67 67 31 0 0 0 0 0 0 0 0 0 0 0 0 30 67 67 67 31 0 0 0 0 
0 0 32 18 15 18 18 15 18 18 15 18 18 18 18 15 18 33 0 0 32 18 18 15 25 67 67 67 24 15 18 18 33 0 0 0 0 32 18 18 15 25 67 67 67 24 15 19 19 33 
0 0 30 55 57 8 42 57 8 8 57 55 8 42 8 23 8 31 0 0 30 55 8 57 42 67 67 67 42 57 8 8 31 0 0 0 0 30 8 8 57 42 67 67 67 42 57 55 8 31 
0 0 30 56 58 67 38 58 67 67 58 56 38 38 67 58 67 31 0 0 30 56 67 58 38 67 67 67 67 58 67 67 31 0 0 0 0 30 67 67 58 38 67 67 67 67 58 56 67 31 
0 0 30 67 67 67 67 67 38 38 67 67 67 67 67 67 67 31 0 0 30 67 67 38 65 67 67 67 67 65 38 67 24 15 27 27 15 25 67 38 65 67 67 38 67 67 67 65 38 31 
0 0 30 67 38 67 68 68 68 68 68 68 68 71 67 67 38 31 0 0 30 67 67 67 58 67 67 67 67 38 67 67 42 57 8 8 57 42 67 67 58 67 38 65 38 67 67 38 67 31 
0 0 30 67 38 67 20 8 8 8 8 8 8 21 67 67 67 31 0 0 30 38 65 67 67 67 38 67 67 67 67 67 67 58 67 67 58 67 67 38 67 67 67 38 67 67 67 67 67 31 
0 0 30 67 67 67 24 15 18 18 15 18 18 25 38 67 67 24 15 15 25 67 15 67 67 38 65 38 67 67 67 67 67 67 67 67 67 67 67 65 38 67 67 67 67 67 38 67 67 31 
0 0 30 67 67 67 42 57 8 8 23 55 8 42 38 67 67 42 57 57 42 67 57 67 67 67 38 67 67 67 65 67 68 68 68 68 68 71 67 58 67 67 15 67 15 38 65 38 67 31 
0 0 30 38 67 67 67 58 67 67 58 56 38 67 67 67 67 67 58 58 67 67 58 67 38 67 67 67 67 67 38 67 13 8 8 8 8 14 67 67 67 38 57 67 57 67 38 67 67 31 
0 0 30 67 67 67 67 38 38 67 67 67 67 67 67 67 67 67 67 67 67 67 67 67 65 38 67 67 65 38 67 67 31 65 65 65 65 30 67 38 65 67 58 67 58 67 67 67 67 31 
0 0 30 67 67 67 68 68 68 68 68 68 68 68 67 67 67 68 68 68 68 68 68 68 71 67 67 67 68 68 68 68 31 0 0 0 0 30 68 68 68 71 67 67 67 68 68 68 68 31 
0 0 30 38 67 67 13 9 9 9 9 9 9 14 67 67 67 20 8 8 8 8 8 8 21 67 67 67 13 9 9 9 29 0 0 0 0 28 8 8 8 21 67 67 67 13 8 8 8 29 
0 0 30 38 67 67 31 32 18 18 18 18 33 30 67 67 67 24 15 26 26 26 26 15 25 67 67 67 24 15 18 15 18 33 0 32 27 15 27 15 27 25 67 67 38 31 65 65 65 0 
0 0 30 67 67 67 31 30 8 8 8 64 31 30 67 38 67 42 57 8 8 8 55 57 42 67 67 67 42 57 8 57 8 31 0 30 8 57 8 57 40 8 67 67 67 31 0 0 0 0 
0 0 30 67 67 37 31 30 37 67 67 67 31 30 67 38 67 67 58 67 38 38 56 58 67 67 67 67 67 58 67 58 67 31 0 30 67 58 67 58 67 67 67 67 38 31 0 0 0 0 
0 0 30 67 67 67 31 30 67 67 67 67 31 30 67 67 67 67 67 67 67 38 67 67 67 67 38 38 67 67 67 67 67 31 0 30 38 67 67 68 68 68 68 68 68 31 0 0 0 0 
0 0 30 67 67 38 31 30 68 68 68 68 31 30 67 67 67 68 68 68 68 68 68 68 71 67 67 67 68 71 67 67 67 31 0 30 67 67 67 8 8 8 8 8 8 29 0 0 0 0 
0 0 30 67 67 38 31 28 8 8 8 8 29 30 67 67 67 13 9 9 9 9 9 9 14 67 67 67 13 14 67 67 38 31 0 30 38 67 67 15 18 15 18 15 18 18 33 0 0 0 
0 0 30 67 67 67 24 19 19 19 15 19 15 25 67 38 67 24 36 36 15 15 36 36 25 67 67 38 31 30 67 67 67 31 0 30 67 67 67 57 40 23 55 57 8 8 31 0 0 0 
0 0 30 38 67 67 42 8 8 8 57 8 57 42 67 67 67 42 8 55 57 57 8 8 42 67 67 67 31 30 38 67 67 31 0 30 67 67 67 58 67 58 56 58 67 67 31 0 0 0 
0 0 30 67 67 67 38 38 67 67 58 67 58 67 38 67 67 67 38 56 58 58 38 38 67 67 67 67 31 30 67 67 67 31 0 30 68 68 68 68 68 68 71 67 67 67 31 0 0 0 
0 0 30 67 67 67 67 67 67 67 38 67 67 67 67 67 67 67 67 67 38 67 67 67 67 67 67 67 31 30 67 67 38 31 0 28 8 8 8 8 8 8 14 67 67 67 31 0 0 0 
0 0 30 38 67 67 68 68 68 68 68 68 68 68 67 67 67 68 68 68 68 68 68 68 71 67 38 67 31 30 67 67 38 24 15 15 34 15 15 59 18 15 25 67 67 38 31 0 0 0 
0 0 30 67 67 67 13 8 8 8 8 8 8 14 67 67 38 20 8 8 8 8 8 8 21 67 67 67 31 30 67 67 67 8 57 23 55 57 57 49 40 23 8 67 67 38 31 0 0 0 
0 0 30 67 67 67 31 32 18 18 18 33 65 30 67 67 67 31 65 65 65 65 65 65 30 67 67 38 31 30 67 67 67 67 58 58 56 58 58 44 58 58 67 67 67 67 31 0 0 0 
0 0 30 67 38 67 31 30 64 8 9 31 0 30 38 67 67 31 0 0 0 0 0 0 30 67 67 38 31 30 38 67 67 67 67 67 67 67 67 67 67 67 67 67 38 67 31 0 0 0 
0 0 30 67 38 67 24 25 68 67 68 24 18 25 67 67 67 24 18 15 18 59 15 18 25 67 67 67 31 30 68 68 68 68 68 68 68 68 71 67 68 68 68 68 68 68 31 0 0 0 
0 0 30 67 67 67 42 8 8 67 8 8 8 42 67 67 67 42 8 57 40 49 57 8 42 67 67 67 31 28 8 8 8 8 8 8 8 8 14 67 13 8 8 8 8 8 29 0 0 0
0 0 30 67 67 67 67 67 67 67 67 67 67 67 67 67 67 38 38 58 67 43 58 67 67 67 67 67 31 0 65 65 65 65 65 65 65 65 30 67 31 65 65 65 65 65 0 0 0 0 
0 0 30 38 67 38 67 67 67 67 67 67 67 67 67 67 67 67 67 67 67 67 67 67 67 67 38 67 31 0 0 0 0 0 0 0 0 0 30 67 31 0 0 0 0 0 0 0 0 0 
0 0 30 68 68 68 68 68 68 68 68 68 68 68 68 68 68 68 68 68 68 68 68 68 68 68 68 68 31 0 0 0 0 0 0 0 0 0 30 37 31 0 0 0 0 0 0 0 0 0 
0 0 28 8 8 8 8 8 8 8 8 8 8 8 8 8 8 8 8 8 8 8 8 8 8 8 8 8 29 0 0 0 0 0 0 0 0 0 0 65 0 0 0 0 0 0 0 0 0 0 
