32 18 18 15 18 15 18 18 33 0 32 15 18 33 0 32 18 15 33 0 32 18 15 15 18 15 15 18 33 0 0 0 0 0 0 0 0 0 0 0 0 0 0 0 0 0 0 0 0 0 
30 8 64 57 8 57 40 8 31 0 30 57 64 31 0 30 64 57 24 18 25 8 57 57 42 57 57 55 31 0 0 0 0 0 0 0 0 0 0 0 0 0 0 0 0 0 0 0 0 0 
30 2 67 58 1 58 65 2 31 0 30 58 67 24 59 25 2 58 8 8 8 38 58 58 67 58 58 56 31 0 0 0 0 0 0 0 0 0 0 0 0 0 0 0 0 0 0 0 0 0 
30 67 2 67 67 2 59 67 31 0 30 2 67 8 54 8 67 2 37 65 39 67 2 67 38 67 38 2 31 0 0 0 0 0 0 0 0 0 0 0 0 0 0 0 0 0 0 0 0 0 
30 1 67 2 67 6 50 2 31 0 30 67 38 67 48 67 38 67 20 8 21 67 38 67 67 38 67 67 31 0 0 0 0 0 0 0 0 0 0 0 0 0 0 0 0 0 0 0 0 0 
30 2 67 67 2 67 44 1 31 0 30 2 67 67 2 67 67 67 31 0 30 38 67 38 2 2 38 67 31 0 0 0 0 0 0 0 0 0 0 0 0 0 0 0 0 0 0 0 0 0 
30 68 71 67 68 68 68 68 31 0 30 68 68 71 67 68 68 68 31 0 30 68 68 69 67 68 68 68 31 0 0 0 0 0 0 0 0 0 0 0 0 0 0 0 0 0 0 0 0 0 
28 8 21 37 20 8 8 8 29 0 28 8 8 21 39 20 8 8 29 0 28 8 8 21 37 20 8 8 29 0 0 0 0 0 0 0 0 32 59 15 19 33 0 0 0 0 0 0 0 0 
32 18 25 65 24 18 15 18 33 0 32 18 15 25 65 24 15 18 33 0 32 18 15 25 65 24 18 18 33 0 0 0 0 0 0 0 0 30 50 57 40 31 0 0 0 0 0 0 0 0 
30 8 12 39 12 8 42 8 31 0 30 8 57 8 37 8 57 8 31 0 30 8 57 8 39 42 55 8 31 0 0 0 0 0 0 0 0 30 45 58 37 31 0 0 0 0 0 0 0 0 
30 1 65 67 67 1 65 2 31 0 30 38 58 67 67 67 58 68 31 0 30 2 58 67 67 67 56 67 31 0 0 0 0 0 0 0 0 30 67 67 67 31 0 0 0 0 0 0 0 0 
30 67 15 5 65 67 15 67 31 0 30 38 67 65 65 65 65 42 31 0 30 67 38 3 38 5 38 67 31 0 0 0 0 0 0 0 0 30 68 67 68 31 0 0 0 0 0 0 0 0 
30 67 57 6 7 2 57 67 31 0 30 3 67 67 1 67 68 68 31 0 30 67 6 38 1 38 7 2 31 0 0 0 0 0 0 0 0 28 21 67 20 29 0 0 0 0 0 0 0 0 
30 67 58 2 67 67 58 67 31 0 30 67 65 65 65 65 42 8 31 0 30 2 38 65 38 65 38 67 31 0 0 0 0 0 0 0 0 32 25 67 24 33 0 0 0 0 0 0 0 0 
30 67 38 67 38 67 38 1 31 0 30 1 67 67 67 38 6 7 31 0 30 67 6 15 67 15 7 67 31 0 0 0 0 0 0 32 15 25 9 67 9 24 15 33 0 0 0 0 0 0 
30 2 1 67 67 38 67 67 31 0 30 38 38 38 67 38 67 67 31 0 30 2 67 57 2 57 2 67 31 0 0 0 0 0 0 30 23 8 7 2 6 8 42 31 0 0 0 0 0 0 
30 68 68 69 67 68 68 68 31 0 30 68 68 71 67 68 68 68 31 0 30 68 68 58 67 58 68 68 31 0 0 0 0 0 0 30 68 71 67 67 67 68 68 31 0 0 0 0 0 0 
28 8 8 21 37 20 8 8 29 0 28 9 9 21 39 20 9 9 29 0 28 9 21 65 37 65 20 9 29 0 0 0 0 0 0 28 8 21 38 67 38 20 8 29 0 0 0 0 0 0 
32 18 15 25 65 24 15 18 33 0 32 18 18 25 65 24 15 18 33 0 32 18 15 18 65 18 15 18 33 0 0 0 0 0 0 32 15 25 67 67 67 24 15 33 0 0 0 0 0 0 
30 8 57 42 39 8 57 55 31 0 30 8 42 8 37 8 57 8 31 0 30 55 57 42 39 8 57 8 31 0 0 0 0 32 15 25 57 8 67 67 67 8 57 24 15 33 0 0 0 0 
30 2 58 67 67 67 58 56 31 0 30 38 67 2 67 67 58 67 31 0 30 56 58 67 1 67 58 67 31 0 0 32 18 25 57 42 58 67 38 67 38 6 58 42 57 24 34 33 0 0 
30 67 65 67 67 67 65 2 31 0 30 67 38 2 65 38 38 67 31 0 30 2 2 67 65 67 67 67 31 0 0 30 8 8 58 2 67 38 2 67 67 38 67 2 58 8 8 31 0 0 
30 2 67 6 65 2 2 67 31 0 30 2 65 67 15 65 65 67 31 0 30 67 65 2 67 6 65 67 31 0 0 30 68 68 68 68 68 69 67 67 67 68 68 68 68 68 68 31 0 0 
30 67 65 3 67 67 65 67 31 0 30 67 0 67 57 2 67 67 31 0 30 38 67 38 2 38 67 38 31 0 0 28 8 8 8 8 8 21 38 67 38 20 8 8 8 8 8 29 0 0 
30 2 67 65 38 65 7 67 31 0 30 67 0 65 58 65 65 67 31 0 30 67 65 5 67 2 65 67 31 0 0 0 0 0 32 19 15 25 67 67 2 24 15 19 33 0 0 0 0 0 
30 38 67 2 67 67 2 38 31 0 30 2 67 67 65 67 2 67 31 0 30 67 2 2 65 2 7 67 31 0 0 0 32 15 25 23 57 42 67 67 67 42 57 8 24 15 33 0 0 0 
30 68 68 71 67 68 68 68 31 0 30 68 68 71 67 68 68 68 31 0 30 68 68 71 67 68 68 68 31 0 0 32 25 57 8 67 58 7 67 67 67 67 58 6 23 57 24 33 0 0 
28 8 8 21 37 20 8 8 29 0 28 8 8 21 39 20 8 8 29 0 28 8 8 21 37 20 8 8 29 0 0 30 42 58 67 67 67 67 2 67 38 38 67 67 67 58 42 31 0 0 
32 18 15 25 0 24 15 18 33 0 32 18 15 25 65 24 15 18 33 0 32 15 19 25 65 24 18 18 33 0 0 30 68 67 67 38 38 38 3 67 67 67 38 38 38 5 68 31 0 0 
30 8 57 42 39 8 57 8 31 0 30 8 42 8 37 8 57 55 31 0 30 57 8 42 39 8 8 8 31 0 0 28 14 68 68 2 67 67 38 38 67 2 67 67 68 68 13 29 0 0
30 2 58 67 67 67 58 67 31 0 30 2 58 67 67 67 58 56 31 0 30 58 65 67 67 38 38 67 31 0 0 0 28 22 14 68 68 2 67 2 2 67 68 68 13 22 29 0 0 0
30 67 65 38 38 38 65 2 31 0 30 67 65 65 65 65 65 67 31 0 30 67 2 5 65 65 38 38 31 0 0 0 0 0 28 22 14 68 68 68 68 68 13 23 29 0 0 0 0 0
30 67 0 7 67 6 0 67 31 0 30 68 15 67 67 67 2 67 31 0 30 2 2 65 6 7 65 38 31 0 0 0 0 0 0 0 28 8 23 8 8 22 29 0 0 0 0 0 0 0 
30 67 38 38 67 67 2 67 31 0 30 42 57 38 67 38 67 2 31 0 30 67 65 67 2 67 2 2 31 0 0 0 0 0 0 0 0 0 0 0 0 0 0 0 0 0 0 0 0 0 
30 67 2 67 67 2 68 67 31 0 30 2 58 38 67 38 38 67 31 0 30 67 67 67 65 67 2 67 31 0 0 0 0 0 0 0 0 0 0 0 0 0 0 0 0 0 0 0 0 0 
30 65 38 38 67 67 42 2 31 0 30 67 38 67 2 67 38 67 31 0 30 2 67 65 2 67 2 67 31 0 0 0 0 0 0 0 0 0 0 0 0 0 0 0 0 0 0 0 0 0 
30 68 68 71 2 68 68 68 31 0 30 68 68 71 67 68 68 68 31 0 30 68 65 71 67 68 68 68 31 0 0 0 0 0 0 0 0 0 0 0 0 0 0 0 0 0 0 0 0 0 
28 9 9 21 37 20 9 9 29 0 28 8 8 21 39 20 8 8 29 0 28 8 0 21 37 20 8 8 29 0 0 0 0 0 0 0 0 0 0 0 0 0 0 0 0 0 0 0 0 0 
32 18 15 25 65 24 15 18 33 0 32 18 15 25 65 24 15 18 33 0 32 18 18 25 65 24 18 18 33 0 32 18 15 18 18 18 15 18 33 0 32 18 19 19 19 19 19 18 33 0 
30 55 57 42 39 42 57 8 31 0 30 9 57 64 37 64 57 9 31 0 30 9 9 64 39 64 9 9 31 0 30 8 57 42 55 42 57 8 31 0 30 8 8 64 8 64 8 8 31 0 
30 56 58 38 2 38 58 2 31 0 30 67 58 2 67 67 58 2 31 0 30 67 38 67 67 67 2 67 31 0 30 4 58 67 56 67 58 4 31 0 30 65 65 65 65 65 65 65 31 0 
30 2 67 38 2 38 65 3 24 18 25 2 67 65 65 65 65 65 31 0 30 65 65 65 65 65 67 67 24 18 25 67 65 4 65 65 65 67 24 26 25 18 15 25 38 24 15 59 31 0 
30 67 67 67 2 5 0 2 8 8 8 67 67 32 18 59 19 33 31 0 30 15 18 18 59 25 3 67 8 8 8 67 0 67 67 67 0 67 8 8 8 8 57 9 37 40 57 51 31 0 
30 67 67 38 38 38 0 67 37 65 39 67 67 28 40 51 8 29 31 0 30 57 10 9 54 55 67 67 37 65 39 1 67 4 5 3 15 67 37 65 39 67 58 58 67 58 58 44 31 0 
30 67 2 67 67 67 0 67 20 8 21 67 67 67 67 44 2 67 31 0 30 2 67 67 46 56 67 67 20 8 21 65 65 65 65 65 57 65 20 8 21 67 2 4 2 4 2 67 31 0 
30 38 38 38 38 67 67 2 31 0 30 67 2 67 67 2 67 67 31 0 30 38 67 2 2 67 2 67 31 0 30 4 4 67 6 7 58 67 31 0 30 67 4 2 4 2 4 67 31 0 
30 68 68 68 68 68 65 68 31 0 30 68 68 68 68 68 68 68 31 0 30 68 68 68 68 68 68 68 31 0 30 68 68 68 68 68 68 68 31 0 30 68 68 68 68 68 68 68 31 0 
28 23 22 22 22 8 0 8 29 0 28 8 22 23 8 8 22 8 29 0 28 8 22 8 8 23 22 8 29 0 28 9 22 9 9 23 9 22 29 0 28 22 8 23 8 8 8 22 29 0 
0 0 0 0 0 0 0 0 0 0 0 0 0 0 0 0 0 0 0 0 0 0 0 0 0 0 0 0 0 0 0 0 0 0 0 0 0 0 0 0 0 0 0 0 0 0 0 0 0 0 
0 0 0 0 0 0 0 0 0 0 0 0 0 0 0 0 0 0 0 0 0 0 0 0 0 0 0 0 0 0 0 0 0 0 0 0 0 0 0 0 0 0 0 0 0 0 0 0 0 0 
