0 32 19 19 19 19 19 33 0 0 0 0 0 0 0 0 0 0 0 0 0 0 0 0 0 0 32 18 59 34 15 34 15 34 34 34 33 0 0 0 0 0 0 0 0 0 0 0 0 0 
0 30 9 64 55 9 9 31 0 0 0 0 0 0 0 0 0 0 0 0 0 0 0 0 0 0 30 8 51 40 57 8 57 8 8 8 31 0 0 0 0 0 0 0 0 0 0 0 0 0 
0 30 67 67 56 6 7 31 0 0 0 0 0 0 0 0 0 0 0 0 0 0 0 0 0 0 30 7 43 67 58 67 58 2 67 6 31 0 0 0 0 0 0 0 0 0 0 0 0 0 
0 30 2 67 67 67 67 31 0 0 0 0 0 0 0 0 0 0 0 0 0 0 0 0 0 0 30 3 67 67 67 67 67 67 67 67 31 0 0 0 0 0 0 0 0 0 0 0 0 0 
0 30 67 67 67 67 2 31 0 0 0 0 0 0 0 0 0 0 0 0 0 0 0 0 0 0 30 68 68 68 68 67 68 68 68 68 31 0 0 0 0 0 0 0 0 0 0 0 0 0 
0 30 67 67 37 2 67 31 0 0 0 0 0 0 0 0 0 0 0 0 0 0 0 0 0 0 28 8 8 8 21 6 20 8 8 8 29 0 0 0 0 0 0 0 0 0 0 0 0 0 
0 30 71 68 74 74 74 31 0 0 0 0 0 0 0 0 0 0 0 0 0 0 0 0 0 0 0 65 0 26 17 67 13 0 65 65 0 0 0 0 0 0 0 0 0 0 0 0 0 0 
0 28 8 8 8 8 8 29 0 0 0 0 0 0 0 0 0 0 0 0 0 0 0 0 0 0 0 0 34 13 7 67 13 0 0 0 0 0 0 0 0 0 0 0 0 0 0 0 0 0 
0 0 65 65 65 65 65 0 0 0 0 0 0 0 0 0 0 0 0 0 0 0 0 0 0 0 0 34 13 67 67 74 13 0 0 0 0 0 0 32 15 59 15 59 15 59 15 59 15 33 
0 0 0 0 0 0 0 0 0 0 0 0 0 0 0 0 0 0 0 0 0 0 0 0 0 0 34 13 67 4 74 13 65 0 0 0 0 0 0 30 57 52 57 54 57 54 57 54 57 31 
0 32 18 18 18 18 15 18 18 18 18 33 0 0 0 0 0 0 0 0 0 0 0 0 0 34 13 7 67 74 13 65 0 0 0 0 0 0 0 30 58 46 58 46 58 46 58 46 58 31 
0 30 8 41 8 8 57 8 8 55 8 16 15 18 15 18 15 18 15 18 15 18 15 18 15 13 67 67 74 13 65 0 0 0 0 0 0 0 0 30 67 67 67 67 37 67 67 2 6 31 
0 30 38 2 37 67 58 6 7 56 67 8 57 41 57 8 57 10 57 10 57 8 57 8 57 67 4 74 13 65 0 0 0 0 0 0 0 0 0 30 1 68 67 67 68 67 67 68 67 31 
0 30 67 67 67 67 67 67 67 2 67 67 58 2 58 67 58 67 58 7 58 67 58 67 58 67 67 31 65 0 0 0 0 0 0 0 0 0 0 30 2 40 67 67 50 67 67 40 67 31 
0 30 67 67 67 67 67 67 67 38 2 68 71 68 68 73 68 68 68 68 68 68 68 68 68 67 67 31 0 0 0 0 0 0 0 0 0 0 0 30 67 5 3 67 45 67 67 2 67 31 
0 30 38 2 67 67 67 67 2 67 2 13 8 8 8 8 8 8 8 8 8 8 8 11 11 67 2 16 18 33 0 0 0 0 0 0 0 0 0 30 67 6 7 67 67 2 67 67 67 31 
0 30 68 68 73 68 71 71 68 68 68 31 65 65 65 65 65 65 65 65 65 65 65 65 8 2 67 11 55 16 33 0 0 0 0 0 0 0 0 30 68 68 68 67 67 67 68 68 68 31 
0 28 8 8 8 8 8 8 8 8 8 29 0 0 0 0 0 0 0 0 0 0 0 0 8 68 67 67 56 11 16 33 0 0 0 0 0 0 0 28 11 8 14 67 37 67 13 8 11 29 
0 0 65 65 65 65 65 65 65 65 65 0 0 0 0 0 0 0 0 0 0 0 0 0 65 8 68 2 67 6 11 16 33 0 0 0 0 0 0 0 0 0 30 68 68 68 31 0 0 0 
0 0 0 0 0 0 32 35 35 15 35 35 15 35 35 33 0 0 0 0 0 0 0 0 0 65 8 68 67 67 38 8 16 33 0 0 0 0 0 0 0 0 28 8 8 8 29 0 0 0 
0 0 0 0 0 32 17 11 8 57 8 8 57 11 11 16 33 0 0 0 0 0 0 0 0 0 65 8 68 67 67 5 11 16 33 0 0 0 0 0 0 0 0 0 0 0 0 0 0 0 
0 0 0 0 32 17 11 8 38 58 7 67 58 8 41 11 16 33 0 0 0 0 0 0 0 0 0 65 8 68 2 67 67 11 16 33 0 0 0 0 0 0 0 0 0 0 0 0 0 0 
0 0 0 32 17 11 40 38 2 67 67 38 67 67 67 40 11 16 33 0 0 0 0 0 0 0 0 0 65 8 68 67 67 7 11 31 0 0 0 0 0 0 0 0 0 0 0 0 0 0 
0 0 0 30 11 41 67 67 38 67 67 67 67 2 38 67 8 11 16 33 0 0 0 0 0 0 0 32 26 15 8 67 67 67 8 16 15 34 33 0 0 0 0 0 0 0 0 0 0 0 
0 0 0 30 8 67 67 2 67 2 67 67 67 67 3 67 67 8 11 31 0 0 0 0 0 0 0 30 10 57 10 38 67 67 8 8 57 8 31 0 0 0 0 0 0 0 0 0 0 0 
0 0 0 30 3 67 2 67 67 67 67 67 67 67 67 67 38 67 8 31 0 0 32 26 59 15 18 17 67 58 67 4 67 2 67 67 58 8 31 0 0 0 0 0 0 0 0 0 0 0 
0 0 0 30 68 39 38 67 67 67 67 67 67 67 67 67 2 67 67 31 0 0 30 8 53 57 8 41 67 67 67 68 68 68 4 67 67 8 16 33 0 0 0 0 0 0 0 0 0 0 
0 0 0 28 8 68 67 38 2 67 67 67 67 2 67 2 67 67 8 31 0 0 30 8 48 58 38 67 67 67 67 13 8 14 67 2 38 41 8 31 0 0 0 0 0 0 0 0 0 0 
0 0 0 0 8 8 68 68 67 67 67 67 67 67 67 67 67 40 11 16 33 0 30 8 67 67 4 4 67 68 74 13 9 14 73 2 67 6 8 16 33 0 0 0 0 0 0 0 0 0 
0 0 0 0 65 8 8 8 68 67 3 38 68 67 67 67 67 3 8 11 31 0 30 38 67 67 67 67 2 13 9 9 65 9 14 68 4 67 8 8 16 33 0 0 0 0 0 0 0 0 
0 0 0 0 0 65 65 8 8 68 67 72 8 70 38 67 67 67 39 8 16 59 17 67 67 4 67 67 68 13 65 65 0 65 8 14 68 67 67 41 8 16 33 0 0 0 0 0 0 0 
0 0 0 0 0 0 0 65 8 8 68 8 11 8 70 67 67 67 67 67 8 52 41 39 67 67 67 38 13 8 0 0 0 0 65 8 14 68 67 67 8 8 16 34 34 34 34 34 33 0 
0 0 0 0 0 0 0 0 65 8 8 8 65 11 14 68 67 67 67 67 67 48 67 67 4 67 67 68 13 65 0 0 0 0 0 65 8 14 68 67 6 8 9 8 41 55 8 8 31 0 
0 0 0 0 0 0 0 0 0 65 65 65 0 65 8 14 68 67 2 67 38 67 67 67 67 38 68 13 8 0 0 0 0 0 0 0 65 8 14 68 67 67 67 39 67 56 7 67 31 0 
0 0 0 0 0 0 0 0 0 0 0 0 0 0 65 8 14 68 67 2 67 67 67 67 67 68 13 8 65 0 0 0 0 0 0 0 0 65 8 14 68 67 3 1 67 67 1 67 31 0 
0 0 0 0 0 0 0 0 0 0 0 0 0 0 0 65 8 14 68 67 67 67 2 67 68 13 8 65 0 0 0 0 0 0 0 0 0 0 65 8 14 67 67 67 67 67 67 67 31 0 
0 0 0 0 0 0 0 0 0 0 0 0 0 0 0 0 65 8 14 68 67 67 67 68 13 8 65 0 0 0 0 0 0 0 0 0 0 0 0 65 14 67 2 5 67 4 37 67 31 0 
0 0 0 0 0 0 0 0 0 0 0 0 0 0 0 0 0 65 8 14 68 39 68 13 8 65 0 0 0 0 0 0 0 0 0 0 0 0 0 0 14 68 68 68 68 68 68 68 31 0 
0 0 0 0 0 0 0 0 0 0 0 0 0 0 0 0 0 0 65 8 14 68 13 8 65 0 0 0 0 0 0 0 0 0 0 0 0 0 0 0 28 8 8 8 8 8 8 8 29 0 
0 0 0 0 0 0 0 0 0 0 0 0 0 0 0 0 0 0 0 65 8 8 8 65 0 0 0 0 0 0 0 0 0 0 0 0 0 0 0 0 0 65 65 65 65 65 65 65 0 0 
0 0 0 0 0 0 0 0 0 0 0 0 0 0 0 0 0 0 0 0 65 65 65 0 0 0 0 0 0 0 0 0 0 0 0 0 0 0 0 0 0 0 0 0 0 0 0 0 0 0 
0 0 0 0 0 0 0 0 0 0 0 0 0 0 0 0 0 0 0 0 0 0 0 0 0 0 0 0 0 0 0 0 0 0 0 0 0 0 0 0 0 0 0 0 0 0 0 0 0 0 
0 0 0 0 0 0 0 0 0 0 0 0 0 0 0 0 0 0 0 0 0 0 0 0 0 0 0 0 0 0 0 0 0 0 0 0 0 0 0 0 0 0 0 0 0 0 0 0 0 0 
0 0 0 0 0 0 0 0 0 0 0 0 0 0 0 0 0 0 0 0 0 0 0 0 0 0 0 0 0 0 0 0 0 0 0 0 0 0 0 0 0 0 0 0 0 0 0 0 0 0 
0 0 0 0 0 0 0 0 0 0 0 0 0 0 0 0 0 0 0 0 0 0 0 0 0 0 0 0 0 0 0 0 0 0 0 0 0 0 0 0 0 0 0 0 0 0 0 0 0 0 
0 0 0 0 0 0 0 0 0 0 0 0 0 0 0 0 0 0 0 0 0 0 0 0 0 0 0 0 0 0 0 0 0 0 0 0 0 0 0 0 0 0 0 0 0 0 0 0 0 0 
0 0 0 0 0 0 0 0 0 0 0 0 0 0 0 0 0 0 0 0 0 0 0 0 0 0 0 0 0 0 0 0 0 0 0 0 0 0 0 0 0 0 0 0 0 0 0 0 0 0 
0 0 0 0 0 0 0 0 0 0 0 0 0 0 0 0 0 0 0 0 0 0 0 0 0 0 0 0 0 0 0 0 0 0 0 0 0 0 0 0 0 0 0 0 0 0 0 0 0 0 
0 0 0 0 0 0 0 0 0 0 0 0 0 0 0 0 0 0 0 0 0 0 0 0 0 0 0 0 0 0 0 0 0 0 0 0 0 0 0 0 0 0 0 0 0 0 0 0 0 0 
0 0 0 0 0 0 0 0 0 0 0 0 0 0 0 0 0 0 0 0 0 0 0 0 0 0 0 0 0 0 0 0 0 0 0 0 0 0 0 0 0 0 0 0 0 0 0 0 0 0 
