0 0 0 0 0 0 0 0 0 0 0 0 0 0 0 0 0 0 0 0 0 0 0 0 0 0 0 0 0 0 0 0 0 0 32 19 15 18 15 19 15 19 15 19 15 19 33 0 0 0 
0 0 0 0 0 0 0 0 18 18 18 0 0 0 0 0 0 0 0 0 0 0 0 0 0 0 0 0 0 0 0 0 0 0 30 8 57 8 57 42 57 8 57 55 57 8 31 0 0 0 
0 0 0 0 0 0 0 30 8 22 8 31 0 0 0 0 0 0 0 0 32 18 15 18 18 18 18 15 15 18 18 18 18 15 25 2 58 67 58 67 58 38 58 56 58 67 31 0 0 0 
0 0 0 0 32 18 15 17 67 67 67 16 15 18 33 0 0 0 0 0 30 8 57 8 8 8 10 57 57 8 8 8 8 57 8 67 2 38 39 38 67 67 67 38 67 2 31 0 0 0 
0 0 0 0 30 8 57 64 67 4 67 55 57 8 31 0 0 0 0 0 30 2 58 67 38 67 2 58 58 39 2 67 38 58 67 2 67 13 8 8 8 8 8 14 67 2 31 0 0 0
0 0 0 0 30 67 58 67 67 67 67 56 58 67 31 0 0 0 0 0 30 67 2 68 68 71 68 68 71 68 68 68 71 71 71 67 67 31 65 65 65 65 65 30 67 2 31 0 0 0 
0 0 0 0 30 67 4 67 4 1 4 1 67 67 31 0 0 0 0 0 30 39 67 13 8 8 8 8 8 8 8 8 8 8 14 2 39 31 0 0 0 0 0 30 2 67 31 0 0 0 
0 0 0 0 30 68 68 68 67 67 67 68 68 68 31 0 0 0 0 0 30 38 67 16 18 18 18 18 18 18 18 33 65 65 30 67 2 31 0 0 0 0 0 30 67 67 31 0 0 0 
0 0 0 0 28 23 8 14 67 67 67 13 23 10 29 0 0 0 0 0 30 67 67 8 8 8 8 8 8 8 8 31 0 0 30 2 67 31 0 0 0 0 0 30 67 39 31 0 0 0 
0 0 0 0 32 18 18 17 67 67 67 16 34 36 33 0 0 0 0 0 30 67 2 67 38 67 4 38 4 4 67 31 0 0 30 67 5 31 0 0 0 0 0 30 67 67 31 0 0 0 
0 0 18 18 17 8 8 8 67 4 67 8 8 8 16 18 18 0 0 0 30 67 67 68 71 68 68 71 71 4 4 31 0 0 30 67 67 31 0 0 0 0 0 30 2 2 31 0 0 0 
0 30 8 42 8 67 67 67 67 67 67 67 67 4 8 42 8 31 0 0 30 38 67 13 8 8 8 8 8 67 38 31 0 0 30 2 2 16 18 15 18 15 18 17 67 67 16 19 19 33 
0 30 67 67 67 67 2 5 8 8 22 7 2 67 67 4 67 31 0 0 30 67 67 31 65 28 8 8 8 4 67 31 0 0 30 4 67 55 42 57 8 57 42 8 67 67 8 42 8 31 
0 30 67 67 18 18 67 67 8 65 8 67 67 18 18 67 67 24 15 26 25 38 2 31 0 30 38 67 4 4 67 31 0 0 30 39 67 56 67 58 2 58 2 67 2 67 67 67 67 31 
0 30 67 67 8 8 67 38 22 0 8 67 67 42 8 67 67 8 57 55 8 67 67 31 0 30 67 67 71 68 68 31 0 0 30 67 67 68 68 71 68 68 68 68 68 68 68 67 39 31 
0 30 67 2 65 65 67 67 8 0 8 67 67 65 65 38 4 67 58 56 67 2 67 31 0 30 4 4 8 42 8 16 15 15 17 67 67 13 8 8 8 8 8 8 8 8 14 67 2 31 
0 30 67 67 18 18 67 2 8 0 22 67 4 18 18 67 67 68 68 68 73 67 67 31 0 30 67 4 8 55 8 8 57 57 8 67 67 31 65 65 65 32 34 15 34 15 17 67 67 31 
0 30 2 67 42 8 3 67 8 15 22 67 67 8 8 67 67 13 8 8 14 67 67 31 0 30 67 4 67 56 4 38 58 58 4 67 67 31 0 0 0 30 42 57 55 57 42 67 2 31 
0 30 67 67 65 65 38 67 23 54 8 67 38 65 65 4 67 31 0 0 30 67 67 31 0 30 68 68 71 68 68 68 71 68 71 4 67 31 0 0 0 30 2 58 56 58 67 67 67 31 
0 30 1 2 38 67 67 67 67 46 67 67 6 7 67 67 4 31 0 0 30 3 67 16 18 17 8 12 40 22 40 8 40 22 14 67 67 31 0 0 0 30 67 67 68 68 68 68 68 31 
0 30 68 68 68 2 2 2 2 67 67 67 67 38 68 68 68 31 0 0 30 7 67 8 8 8 12 23 12 12 9 11 51 23 14 4 67 31 0 0 0 30 38 67 13 9 9 9 9 29 
0 28 11 11 8 70 68 68 68 68 68 68 68 72 8 11 8 29 0 0 30 67 67 1 38 2 67 38 39 67 39 6 44 67 67 67 67 31 0 0 0 30 38 67 16 34 34 34 34 33 
0 0 65 65 65 11 11 8 22 8 8 23 11 8 65 65 65 0 0 0 30 67 67 68 68 68 68 68 68 68 68 68 68 68 68 68 68 31 0 0 0 30 2 67 9 8 8 8 8 31 
0 0 0 0 0 65 65 65 65 65 65 65 65 32 18 15 18 15 18 15 17 67 67 13 8 8 8 8 8 8 8 8 8 8 8 8 8 29 0 0 0 30 67 2 67 67 67 67 2 31 
0 0 32 18 18 18 18 33 0 0 0 0 0 30 8 57 40 57 42 57 8 67 67 31 65 65 65 65 65 65 65 65 65 65 65 65 65 0 0 0 0 30 67 67 38 38 38 38 67 31 
0 0 30 55 64 8 8 31 0 0 0 0 0 30 67 58 67 58 67 58 67 2 67 16 15 19 19 19 15 19 19 19 15 19 19 19 15 19 19 19 15 17 67 2 38 37 67 38 2 31 
0 0 30 56 67 67 67 31 0 0 0 0 0 30 2 67 68 68 68 68 68 67 2 8 57 55 9 9 57 42 9 9 57 9 9 42 57 9 9 9 57 42 67 67 38 38 67 38 67 31 
0 0 30 67 67 67 67 31 0 0 0 0 0 30 67 2 13 8 8 8 14 67 67 67 58 56 67 38 58 67 67 38 58 2 67 67 58 2 38 67 58 67 67 67 67 67 2 38 67 31 
0 0 30 67 67 37 67 31 0 0 0 0 0 30 38 67 31 0 0 0 30 68 68 68 68 68 68 68 68 68 68 68 68 68 68 68 68 68 68 68 68 68 68 68 68 68 68 68 68 31 
0 0 30 68 68 68 68 31 0 0 0 0 0 30 38 67 31 0 0 0 28 8 8 8 8 8 8 8 8 8 8 8 8 8 8 8 8 8 8 8 8 8 8 8 8 8 8 8 8 29 
0 0 28 8 8 8 8 29 0 0 0 0 0 30 67 67 31 0 0 0 0 65 65 65 65 65 65 65 65 65 65 65 65 65 65 65 65 65 65 65 65 65 65 65 65 65 65 65 65 0 
0 0 0 65 65 65 65 0 0 0 0 0 0 30 67 2 31 0 32 18 15 18 15 18 15 18 15 18 18 18 33 32 18 18 18 15 18 18 59 18 18 18 15 18 33 0 0 0 0 0 
0 0 0 0 0 0 0 0 0 0 0 0 0 30 67 67 31 0 30 8 57 8 8 8 57 8 57 8 55 8 31 30 8 9 23 57 55 10 54 42 8 22 57 8 31 0 0 0 0 0 
0 0 0 0 0 0 32 18 15 18 15 18 15 17 2 67 16 15 17 67 58 6 58 7 58 67 58 1 56 2 16 17 39 6 67 58 56 6 47 2 67 2 58 67 31 0 0 0 0 0 
0 0 0 0 0 0 30 42 57 8 57 40 57 8 67 67 42 57 8 67 38 3 38 2 38 67 38 67 38 67 42 42 67 38 6 38 67 38 67 38 39 38 6 38 31 0 0 0 0 0 
0 0 0 0 0 0 30 2 58 2 58 67 58 67 67 2 67 58 67 67 67 67 67 67 2 67 2 67 2 67 67 2 67 67 67 67 67 2 67 67 2 67 2 6 31 0 0 0 0 0 
0 0 0 0 0 0 30 67 67 68 68 68 68 68 68 68 68 68 68 67 2 67 67 67 67 67 2 67 67 2 68 68 67 67 2 67 67 67 5 3 2 2 67 67 31 0 0 0 0 0 
0 0 0 0 0 0 30 67 67 13 8 8 8 8 8 8 8 8 14 67 38 67 38 67 38 5 38 2 38 7 13 14 67 38 67 38 67 38 6 38 7 38 2 38 31 0 0 0 0 0 
0 0 0 0 0 0 30 2 67 31 65 65 65 65 65 65 65 65 30 68 68 68 68 68 68 68 68 68 68 68 31 30 67 1 2 67 67 2 67 67 67 2 2 67 31 0 0 0 0 0 
0 0 0 0 0 0 30 38 2 31 0 0 0 0 0 0 0 0 28 8 8 8 8 8 8 8 8 8 8 8 29 30 67 38 5 38 39 38 2 38 67 38 39 38 31 0 0 0 0 0 
0 0 0 0 0 0 30 38 67 31 0 0 0 0 0 0 0 0 0 32 18 15 18 15 18 15 18 65 65 65 0 30 68 68 68 68 68 68 68 68 68 68 68 69 31 0 0 0 0 0 
0 0 0 0 0 0 30 2 67 31 0 0 0 0 0 0 0 0 0 30 8 57 12 57 42 57 8 31 0 0 0 28 8 8 8 8 8 8 8 8 8 8 8 8 29 0 0 0 0 0 
0 0 0 0 0 0 30 67 67 31 0 0 0 0 0 0 0 32 34 17 3 58 2 58 38 58 1 16 18 33 0 0 65 65 65 65 65 65 65 65 32 18 59 18 33 0 0 0 0 0 
0 0 0 0 0 0 30 38 67 31 0 0 0 0 0 0 0 30 8 8 67 67 67 67 67 67 67 8 8 31 0 0 0 0 0 0 0 0 0 0 30 8 51 8 31 0 0 0 0 0 
0 0 0 0 0 0 30 38 2 16 15 18 18 15 18 18 15 17 7 67 2 5 65 65 65 3 67 2 38 16 15 36 36 36 15 15 36 36 36 15 17 2 43 1 31 0 0 0 0 0 
0 0 0 0 0 0 30 2 67 8 57 42 8 57 8 40 57 55 67 67 68 68 68 68 68 68 68 67 5 8 57 40 8 8 57 57 8 8 40 57 8 3 37 67 31 0 0 0 0 0 
0 0 0 0 0 0 30 67 2 67 58 67 67 58 38 38 58 56 67 67 13 8 8 8 8 8 14 67 67 2 58 67 67 6 58 58 7 67 67 58 6 7 67 2 31 0 0 0 0 0 
0 0 0 0 0 0 30 68 68 68 68 68 68 68 68 68 68 68 68 68 31 65 65 65 65 65 30 68 68 68 68 68 68 68 68 68 68 68 68 68 68 68 68 68 31 0 0 0 0 0 
0 0 0 0 0 0 28 8 8 8 8 8 8 8 8 8 8 8 8 8 29 0 0 0 0 0 28 8 8 8 8 8 8 8 8 8 8 8 8 8 8 8 8 8 29 0 0 0 0 0 
0 0 0 0 0 0 0 65 65 65 65 65 65 65 65 65 65 65 65 65 0 0 0 0 0 0 0 65 65 65 65 65 65 65 65 65 65 65 65 65 65 65 65 65 0 0 0 0 0 0 
